############################
#P...........##............#
#.####.#####.##.#####.####.#
#.#  #.#   #.##.#   #.#  #.#
#.####.#####.##.#####.####.#
#..........................#
#.####.##.########.##.####.#
#......##....##....##......#
######.#####.##.#####.######
#..........................#
#.####.##.########.##.####.#
#......##....##....##......#
#.####.#####.##.#####.####.#
#..........................#
#.####.##.########.##.####.#
#......##....##....##......#
######.#####.##.#####.######
#..........................#
#.####.#####.##.#####.####.#
#.#  #.#   #.##.#   #.#  #.#
#.####.#####.##.#####.####.#
#..........................#
#............##............#
############################
